
point of sale=>pointofsale
tree care=>treecare
tree prune=>treeprune
tree service=>treeservice
tree surgeon=>treesurgeon
tree top=>treetop
mixed media=>mixedmedia
bio chemcial=>biochemcial
bio chemical=>biochemical
bio hazard=>biohazard
night stand=>nightstand
food service=>foodservice
bed and breakfast=>bedandbreakfast
motor court=>motorcourt
time share=>timeshare
aroma therapy=>aromatherapy
essential oils=>essentialoils
smart homes=>smarthomes
back hoe=>backhoe
motor cycle=>motorcycle
vending machine=>vendingmachine
prince george=>princegeorge
post trauma=>posttrauma
queen charlotte=>queencharlotte
port coquitlam=>portcoquitlam
fire department=>firedepartment
fire fighter=>firefighter
fire fighters=>firefighters
fire protection=>fireprotection
fire rescue=>firerescue
fire services=>fireservices
crypto currency=>cryptocurrency
drive way=>driveway
road work=>roadwork
bubble tea=>bubbletea
chai tea=>chaitea
cheese tea=>cheesetea
energy drink=>energydrink
hot chocolate=>hotchocolate
public house=>publichouse
social house=>socialhouse
tap house=>taphouse
fifth wheel=>fifthwheel
1st nation=>1stnation
1st people=>1stpeople
first nation=>firstnation
first people=>firstpeople